XXXXXXX2222XXXXXXX
X              H0X
X                X
X       T        X
X       T        X
X                X
X    XX   XH1    X
X     X XX       X
X    SXX         X
X     X XX H2    X
X    XX   X      X
X                X
X                X
X     B2         X
X                X
X      TT      H0X
X                X
XXXXXXX1111XXXXXXX
